O- O- O- O- x- x- x-
O- Op O- O- O- O- O-
O- O- O- O- O- O- O-
O- O- O- O- O- O- OT
O- O- O- O- O- O- O-
O- O- O- O- O- O- O-
|- |e |- |- |- |g O-
OT O- O- O- O- O- O-
OT OT O- O- O- O- O-