|- O- O- x- x- x- O- O-
|- O- O- O- O- x- O- O-
|- O- O- O- x- x- O- O-
|- O- Op O- x- |g |- |-
|- OT O- Or x- |- O- |-
|- OT x- Or OT |- O- |-
|e |- |- |- |- |t O- |-
O- O- O- OT O- O- O- |-
O- O- O- O- O- O- O- |-
O- O- O- O- O- O- O- |-
O- O- O- O- O- OT O- |-
O- O- O- O- O- O- O- |-
OT OT O- O- O- O- O- |-
OT OT OT O- O- O- O- |-
OT OT OT OT OT O- O- |e