|- |- |- |- |- |- |- |- |-
|- x- x- x- x- x- x- x- |-
|- x- O- O- O- Or Or x- |-
|e x- O- O- O- O- Or x- |-
|- x- O- OT Op O- Or x- |g
|e x- O- O- O- O- Or x- |-
|- x- O- O- O- Or Or x- |-
|- x- x- x- x- x- x- x- |-
|- |- |- |- |- |- |- |- |-