x- x- O- O- O- O- O- O- O- x-
O- O- O- O- O- O- O- O- O- O-
O- O- O- |e Op O- Ot O- O- O-
O- O- |e |- |- O- O- O- O- O-
O- O- O- |- |g O- Or O- O- O-
O- O- O- |- |- Ot O- O- O- O-
O- O- O- O- |- O- O- O- O- O-
O- O- O- O- |- |- |- O- O- O-
O- O- O- O- O- |- |- O- O- O-
O- O- O- O- O- O- |e |- |- |e
