O- O- |L O- O- O- O- O-
O- O- |- O- O- O- O- O-
O- O- |- Op O- O- O- O-
O- O- |- O- O- O- O- O-
O- O- |- |- |- |- O- O-
O- O- Ot O- O- |- O- O-
O- |- |- |- |- |- O- O-
O- |g O- O- O- O- O- O-
O- O- O- O- O- O- O- O-