O- O- |e O- O- O- O- O-
O- O- |e O- O- O- O- O-
O- O- |- O- O- O- O- Of
O- O- |- O- O- O- O- O-
O- O- |- |- |- /- 0- O-
O- O- Od O- Op |- O- O-
O- |- |- |- |- |f O- Of
O- |g O- O- O- O- O- O!
O- O- O- O- O- O- O- O^