O- O- |e O- O- O- O- O-
O- O- |e O- O- O- O- O-
O- O- |- O- O- O- O- O-
O- O- |- O- O- Oy O- O-
O- O- |- |- |- |- O- O-
O- O- Ou Ok Op |- O- O-
O- |- |- |- |- |- O- O-
O- |g O- O- O- O- O- O-
O- O- O- O- O- O- O- O-